3,1,1,1,1,1,1,1,1,4
2,0,7,7,7,7,7,7,0,2
2,8,3,1,1,1,1,4,8,2
2,8,2,0,0,0,0,2,8,2
2,8,2,0,0,0,0,2,8,2
2,8,2,0,0,0,0,2,8,2
2,8,2,0,0,0,0,2,8,2
2,0,6,1,1,1,1,5,8,2
2,0,7,7,7,7,7,7,0,2
6,1,1,1,1,1,1,1,1,5